# Right connector C1 chamber T type
# 2013 - 03 - 14 M.Bianco
# Panasonic pin  # multilayer # layer # readout # Strip
2  	0	0	X     161
3  	0	0	X     160
4  	0	0	X     162
5  	0	0	X     159
6  	0	0	X     163
7  	0	0	X     158
8  	0	0	X     164
9  	0	0	X     157
10 	0	0	X     165
11 	0	0	X     156
12 	0	0	X     166
13 	0	0	X     155
14 	0	0	X     167
15 	0	0	X     154
16 	0	0	X     168
17 	0	0	X     153
18 	0	0	X     169
19 	0	0	X     152
20 	0	0	X     170
21 	0	0	X     151
22 	0	0	X     171
23 	0	0	X     150
24 	0	0	X     172
25 	0	0	X     149
26 	0	0	X     173
27 	0	0	X     148
28 	0	0	X     174
29 	0	0	X     147
30 	0	0	X     175
31 	0	0	X     146
32 	0	0	X     176
33 	0	0	X     145
34 	0	0	X     177
35 	0	0	X     144
36 	0	0	X     178
37 	0	0	X     143
38 	0	0	X     179
39 	0	0	X     142
40 	0	0	X     180
41 	0	0	X     141
42 	0	0	X     181
43 	0	0	X     140
44 	0	0	X     182
45 	0	0	X     139
46 	0	0	X     183
47 	0	0	X     138
48 	0	0	X     184
49 	0	0	X     137
50 	0	0	X     185
51 	0	0	X     136
52 	0	0	X     186
53 	0	0	X     135
54 	0	0	X     187
55 	0	0	X     134
56 	0	0	X     188
57 	0	0	X     133
58 	0	0	X     189
59 	0	0	X     132
60 	0	0	X     190
61 	0	0	X     131
62 	0	0	X     191
63 	0	0	X     130
64 	0	0	X     192
65 	0	0	X     129
66 	0	0	X     193
67 	0	0	X     256
68 	0	0	X     194
69 	0	0	X     255
70 	0	0	X     195
71 	0	0	X     254
72 	0	0	X     196
73 	0	0	X     253
74 	0	0	X     197
75 	0	0	X     252
76 	0	0	X     198
77 	0	0	X     251
78 	0	0	X     199
79 	0	0	X     250
80 	0	0	X     200
81 	0	0	X     249
82 	0	0	X     201
83 	0	0	X     248
84 	0	0	X     202
85 	0	0	X     247
86 	0	0	X     203
87 	0	0	X     246
88 	0	0	X     204
89 	0	0	X     245
90 	0	0	X     205
91 	0	0	X     244
92 	0	0	X     206
93 	0	0	X     243
94 	0	0	X     207
95 	0	0	X     242
96 	0	0	X     208
97 	0	0	X     241
98 	0	0	X     209
99 	0	0	X     240
100	0	0	X     210
101	0	0	X     239
102	0	0	X     211
103	0	0	X     238
104	0	0	X     212
105	0	0	X     237
106	0	0	X     213
107	0	0	X     236
108	0	0	X     214
109	0	0	X     235
110	0	0	X     215
111	0	0	X     234
112	0	0	X     216
113	0	0	X     233
114	0	0	X     217
115	0	0	X     232
116	0	0	X     218
117	0	0	X     231
118	0	0	X     219
119	0	0	X     230
120	0	0	X     220
121	0	0	X     229
122	0	0	X     221
123	0	0	X     228
124	0	0	X     222
125	0	0	X     227
126	0	0	X     223
127	0	0	X     226
128	0	0	X     224
129	0	0	X     225
