# Right connector C1 chamber T type
# 2013 - 03 - 14 M.Bianco
# Panasonic pin  # multilayer # layer # readout # Strip
2  	0	0	X     160
3  	0	0	X     159
4  	0	0	X     161
5  	0	0	X     158
6  	0	0	X     162
7  	0	0	X     157
8  	0	0	X     163
9  	0	0	X     156
10 	0	0	X     164
11 	0	0	X     155
12 	0	0	X     165
13 	0	0	X     154
14 	0	0	X     166
15 	0	0	X     153
16 	0	0	X     167
17 	0	0	X     152
18 	0	0	X     168
19 	0	0	X     151
20 	0	0	X     169
21 	0	0	X     150
22 	0	0	X     170
23 	0	0	X     149
24 	0	0	X     171
25 	0	0	X     148
26 	0	0	X     172
27 	0	0	X     147
28 	0	0	X     173
29 	0	0	X     146
30 	0	0	X     174
31 	0	0	X     145
32 	0	0	X     175
33 	0	0	X     144
34 	0	0	X     176
35 	0	0	X     143
36 	0	0	X     177
37 	0	0	X     142
38 	0	0	X     178
39 	0	0	X     141
40 	0	0	X     179
41 	0	0	X     140
42 	0	0	X     180
43 	0	0	X     139
44 	0	0	X     181
45 	0	0	X     138
46 	0	0	X     182
47 	0	0	X     137
48 	0	0	X     183
49 	0	0	X     136
50 	0	0	X     184
51 	0	0	X     135
52 	0	0	X     185
53 	0	0	X     134
54 	0	0	X     186
55 	0	0	X     133
56 	0	0	X     187
57 	0	0	X     132
58 	0	0	X     188
59 	0	0	X     131
60 	0	0	X     189
61 	0	0	X     130
62 	0	0	X     190
63 	0	0	X     129
64 	0	0	X     191
65 	0	0	X     256
66 	0	0	X     192
67 	0	0	X     255
68 	0	0	X     193
69 	0	0	X     254
70 	0	0	X     194
71 	0	0	X     253
72 	0	0	X     195
73 	0	0	X     252
74 	0	0	X     196
75 	0	0	X     251
76 	0	0	X     197
77 	0	0	X     250
78 	0	0	X     198
79 	0	0	X     249
80 	0	0	X     199
81 	0	0	X     248
82 	0	0	X     200
83 	0	0	X     247
84 	0	0	X     201
85 	0	0	X     246
86 	0	0	X     202
87 	0	0	X     245
88 	0	0	X     203
89 	0	0	X     244
90 	0	0	X     204
91 	0	0	X     243
92 	0	0	X     205
93 	0	0	X     242
94 	0	0	X     206
95 	0	0	X     241
96 	0	0	X     207
97 	0	0	X     240
98 	0	0	X     208
99 	0	0	X     239
100	0	0	X     209
101	0	0	X     238
102	0	0	X     210
103	0	0	X     237
104	0	0	X     211
105	0	0	X     236
106	0	0	X     212
107	0	0	X     235
108	0	0	X     213
109	0	0	X     234
110	0	0	X     214
111	0	0	X     233
112	0	0	X     215
113	0	0	X     232
114	0	0	X     216
115	0	0	X     231
116	0	0	X     217
117	0	0	X     230
118	0	0	X     218
119	0	0	X     229
120	0	0	X     219
121	0	0	X     228
122	0	0	X     220
123	0	0	X     227
124	0	0	X     221
125	0	0	X     226
126	0	0	X     222
127	0	0	X     225
128	0	0	X     223
129	0	0	X     224
